11111111111111111111
100000000000000000E1
10000000000000000001
10000000000000000001
10000C000000P0000011
11111111111111111111