111111111111
100000000001
100000000001
100000000001
10000C000001
100000000001
100000000001
100000000001
100000P00001
100000000001
10E000000001
111111111111