11111111111111111111
10000000E00000000001
1000000000P000000001
10000000000000000001
10000C00000000000011
11111111111111111111