11111111111111111111
10000000000000000001
10000P00000000000001
10000000000000C00001
100000000E0000000001
11111111111111111111