1111111111111111
1P00000000000001
1011101111011101
1011101001011101
1000001111000001
1111100000011111
1000001111000001
1111101111000111
1111101111000111
1CC0000C0000CC01
1011111111111101
1000001111000001
1111100C00011111
1111100000011111
1111100110011111
1000000CC0000001
1000000000000001
1000000000000001
1011101111011101
1011101111011111
1011100000011101
1C000011110011C1
1000001111000E01
1111111111111111