111111111111
10C1111100C1
100111C10111
101111010011
10000C000001
1C0011110011
100000000001
111100000111
1111000P01C1
1000000001C1
10E000000001
111111111111