11111111111111111111
1000000000000E000001
10000P00000000000001
10000000000000000001
10000C00000000000111
11111111111111111111