111111111111
101111110001
100111110111
101111110011
10000C000001
110011110011
100000000001
111100000111
1111000P0101
100000000101
10E000000001
111111111111