11111111111111111110
1000000000000E000001
100000P0000000000001
10000000000000000001
10000C00000000000011
11111111111111111111