1111111111111111
1P10100000000001
1011101111011101
1011101001011101
1000001111000001
1111100000011111
1001001111000001
11111011110E0111
1111101111000111
1CC0000C0000CC01
1011111111111101
1111111111111111