11111111111111111111
10000000000000000001
10000000000000000001
10000000000000000001
10000C0000000P000011
11111111111111111111