11111111111111
1000000P000001
10011100111001
10010000001001
10010111101001
1C0101111010C1
100100C00C1001
10011100111001
10C000000000E1
11111111111111