11111111111
111C0E0C111
11110001111
1C111011101
1C000000001
1C0000000P1
11111111111