1111111111111
10000CCCCCCE1
1000011111CC1
1P000CCCCCCC1
1111111111111