

111111111111111111111111111111

101111100011100011C11110000011
1E0000000001111011111111011011
101101011000000000000000011011
101101011110111111111111111001
1P1000010000100000000000000001
111111111111111111111111111111