1111111111111111111111111111111111111111
101111100011100011C111100000100000000001
101111100011100011C111100000100000000001
101111100011100011C1111000001000P0000001
1011010111101111111111111110000000000001
1010000100001000000000000000000000000001
1111111111111111111111111110100000000001
11111111111111111111111111101000C0000001
1111111111111111111111111110100000000001
1111111111111111111111111110100000000001
1111111111111111111111111110100000000001
11111111111111111111111111101000E0000001
1111111111111111111111111110100000000001
1111111111111111111111111110100000000001
1111111111111111111111111110100000000001
1111111111111111111111111110100000000001
1111111111111111111111111110100000000001
1111111111111111111111111110100000000001
1111111111111111111111111110100000000001
1111111111111111111111111110100000000001
1111111111111111111111111110100000000001
1111111111111111111111111110100000000001
1111111111111111111111111110100000000001
1111111111111111111111111110100000000001
1111111111111111111111111110100000000001
1111111111111111111111111110100000000001
1111111111111111111111111110100000000001
1111111111111111111111111111111111111111