11111111111
111CCECC111
1111CCC1111
1C111C111C1
1C0000000C1
1C000P000C1
11111111111