11111111111
111CCCCC111
1111CCC1111
1C111E111C1
100N00000N1
10000P00001
11111111111