111111111111111111111111111111
111111111111111111100011111111
111111111111111111100011111111
111111111111111111110111111111
111111111111111111110111111111
111111111100111111110111111111
111111111100111111000011111111
111111110000111111011011111111
111000110110000000011010000111
1100E0000110011101010000C00111
110100110110011100010000000111
110110110000000001111111011111
110000110000000001111111011111
110000110000000001110000011111
111000110000000001110111111111
111100110000000000000111111111
111111111111101111111111111111
1111111111111P1111111111111111
111111111111111111111111111111