11111111111
111CCCCC111
1111CCC1111
1C1110111C1
100N00N0001
10000P00001
11111011111
11111E11111
11111111111