11111111111
1N000P000N1
1C1110111C1
1C1CCCCC1C1
1C1C111C1C1
1C1C1T1C1C1
101CCCCC101
10111011101
10000000001
11111E11111
11111111111