1111111111111
10000000000E1
100N011111001
1P00000000N01
1111111111111