1111111111111
10000000000E1
100N011111001
1P0000C000001
1111111111111