11111111111
111CCCCC111
1111CCC1111
10111E11101
100N000N001
100N0P0N001
11111111111