11111111111
10000P00001
1C1110111C1
1C1CCCCC1C1
1C1C111C1C1
1C1C111C1C1
101CCCCC101
10111011101
100000000E1
11111111111