111111111111111111111111111111
1111111111111111111CPC11111111
1111111111111111111CCC11111111
111111111111111111110111111111
111111111111111111110111111111
111111111100111111110111111111
111111111100111111000011111111
111111110000111111011011111111
11100011011N00000001101CCCC111
1100N000011001110101CCCCCCC111
1101C011011001110001CCCCCCC111
110110110000000001111111011111
110000110000000001111111011111
110N0011000N000001110000011111
111000110000000001110111111111
11110011T000000000000111111111
111111111111101111111111111111
1111111111111E1111111111111111
111111111111111111111111111111